(supertux-level
  (version 3)
  (name (_ "Laptop Level"))
  (author "Sophie Ball")
  (license "CC-BY-SA 4.0 International")
  (target-time 50)
  (allow-item-pocket "inherit")
  (icon "")
  (icon-locked "")
  (statistics
    (enable-coins #t)
    (enable-secrets #t)
  )
  (sector
    (name "main")
    (ambient-light
      (color 1 1 1)
    )
    (background
      (color 1 1 1)
      (alignment "top")
      (scroll-speed-x -10)
      (speed 0)
      (image "/images/background/misc/skybox.png")
      (z-pos -399)
    )
    (background
      (color 1 1 1)
      (alignment "bottom")
      (speed 0)
      (image "/images/background/retro/arctis_skyline.png")
      (z-pos -398)
    )
    (background
      (color 1 1 1)
      (alignment "bottom")
      (speed 0.04)
      (image "/images/background/retro/arctis_icechunk.png")
      (z-pos -350)
    )
    (background
      (color 1 1 1)
      (alignment "bottom")
      (speed 0.4)
      (image "/images/background/retro/arctis_shore.png")
    )
    (bonusblock
      (type "retro")
      (z-pos 51)
      (x 544)
      (y 992)
    )
    (bonusblock
      (type "retro")
      (z-pos 51)
      (x 608)
      (y 992)
    )
    (bonusblock
      (type "retro")
      (z-pos 51)
      (x 576)
      (y 992)
    )
    (bonusblock
      (type "retro")
      (z-pos 51)
      (x 640)
      (y 992)
    )
    (bonusblock
      (type "retro")
      (z-pos 51)
      (x 672)
      (y 992)
    )
    (bonusblock
      (type "retro")
      (z-pos 51)
      (x 992)
      (y 992)
    )
    (bonusblock
      (type "retro")
      (z-pos 51)
      (x 960)
      (y 992)
    )
    (bonusblock
      (type "retro")
      (z-pos 51)
      (contents "retrogrow")
      (x 928)
      (y 992)
    )
    (bonusblock
      (type "retro")
      (z-pos 51)
      (x 896)
      (y 992)
    )
    (bonusblock
      (type "retro")
      (z-pos 51)
      (x 864)
      (y 992)
    )
    (bonusblock
      (type "retro")
      (z-pos 51)
      (x 1728)
      (y 832)
    )
    (bonusblock
      (type "retro")
      (z-pos 51)
      (x 1792)
      (y 832)
    )
    (bonusblock
      (type "retro")
      (z-pos 51)
      (x 1760)
      (y 832)
    )
    (bonusblock
      (type "retro")
      (z-pos 51)
      (x 1696)
      (y 832)
    )
    (bonusblock
      (type "retro")
      (z-pos 51)
      (x 1664)
      (y 832)
    )
    (bonusblock
      (type "retro")
      (z-pos 51)
      (x 3424)
      (y 640)
    )
    (bonusblock
      (type "retro")
      (z-pos 51)
      (x 3584)
      (y 640)
    )
    (bonusblock
      (type "retro")
      (z-pos 51)
      (x 3488)
      (y 640)
    )
    (bonusblock
      (type "retro")
      (z-pos 51)
      (x 3520)
      (y 640)
    )
    (bonusblock
      (type "retro")
      (z-pos 51)
      (x 4032)
      (y 704)
    )
    (bonusblock
      (type "retro")
      (z-pos 51)
      (x 4064)
      (y 704)
    )
    (bonusblock
      (type "retro")
      (z-pos 51)
      (x 4576)
      (y 608)
    )
    (bonusblock
      (type "retro")
      (z-pos 51)
      (x 4608)
      (y 608)
    )
    (bonusblock
      (type "retro")
      (z-pos 51)
      (x 4960)
      (y 576)
    )
    (bonusblock
      (type "retro")
      (z-pos 51)
      (x 4992)
      (y 576)
    )
    (bonusblock
      (type "retro")
      (z-pos 51)
      (x 5536)
      (y 512)
    )
    (bonusblock
      (type "retro")
      (z-pos 51)
      (x 5504)
      (y 512)
    )
    (bonusblock
      (type "retro")
      (z-pos 51)
      (x 5472)
      (y 512)
    )
    (bonusblock
      (type "retro")
      (z-pos 51)
      (x 5568)
      (y 512)
    )
    (bonusblock
      (type "retro")
      (z-pos 51)
      (x 6016)
      (y 448)
    )
    (bonusblock
      (type "retro")
      (z-pos 51)
      (x 6112)
      (y 448)
    )
    (bonusblock
      (type "retro")
      (z-pos 51)
      (x 6080)
      (y 448)
    )
    (bonusblock
      (type "retro")
      (z-pos 51)
      (x 6048)
      (y 448)
    )
    (bonusblock
      (type "retro")
      (z-pos 51)
      (x 6656)
      (y 384)
    )
    (bonusblock
      (type "retro")
      (z-pos 51)
      (x 6624)
      (y 384)
    )
    (bonusblock
      (type "retro")
      (z-pos 51)
      (x 6592)
      (y 384)
    )
    (bonusblock
      (type "retro")
      (z-pos 51)
      (x 6560)
      (y 384)
    )
    (bonusblock
      (type "retro")
      (z-pos 51)
      (x 8512)
      (y 736)
    )
    (bonusblock
      (type "retro")
      (z-pos 51)
      (contents "retrogrow")
      (x 8480)
      (y 736)
    )
    (bonusblock
      (type "retro")
      (z-pos 51)
      (x 8448)
      (y 736)
    )
    (bonusblock
      (type "retro")
      (z-pos 51)
      (x 8640)
      (y 736)
    )
    (bonusblock
      (type "retro")
      (z-pos 51)
      (x 8608)
      (y 736)
    )
    (bonusblock
      (type "retro")
      (z-pos 51)
      (x 8672)
      (y 736)
    )
    (bonusblock
      (type "retro")
      (z-pos 51)
      (x 7104)
      (y 544)
    )
    (bonusblock
      (type "retro")
      (z-pos 51)
      (x 7200)
      (y 544)
    )
    (bonusblock
      (type "retro")
      (z-pos 51)
      (x 7168)
      (y 544)
    )
    (bonusblock
      (type "retro")
      (z-pos 51)
      (x 7136)
      (y 544)
    )
    (bonusblock
      (type "retro")
      (z-pos 51)
      (x 10112)
      (y 832)
    )
    (bonusblock
      (type "retro")
      (z-pos 51)
      (x 10688)
      (y 768)
    )
    (bonusblock
      (type "retro")
      (z-pos 51)
      (x 11232)
      (y 736)
    )
    (bonusblock
      (type "retro")
      (z-pos 51)
      (x 11264)
      (y 736)
    )
    (bonusblock
      (type "retro")
      (z-pos 51)
      (x 11200)
      (y 736)
    )
    (bonusblock
      (type "retro")
      (z-pos 51)
      (x 11808)
      (y 640)
    )
    (bonusblock
      (type "retro")
      (z-pos 51)
      (x 12448)
      (y 576)
    )
    (bonusblock
      (type "retro")
      (z-pos 51)
      (x 13088)
      (y 576)
    )
    (bonusblock
      (type "retro")
      (z-pos 51)
      (x 14176)
      (y 544)
    )
    (bonusblock
      (type "retro")
      (z-pos 51)
      (x 14144)
      (y 544)
    )
    (bonusblock
      (type "retro")
      (z-pos 51)
      (x 14560)
      (y 544)
    )
    (bonusblock
      (type "retro")
      (z-pos 51)
      (x 14592)
      (y 544)
    )
    (bonusblock
      (type "retro")
      (z-pos 51)
      (x 15072)
      (y 736)
    )
    (bonusblock
      (type "retro")
      (z-pos 51)
      (x 15136)
      (y 736)
    )
    (bonusblock
      (type "retro")
      (z-pos 51)
      (x 15104)
      (y 736)
    )
    (bonusblock
      (type "retro")
      (z-pos 51)
      (x 15168)
      (y 736)
    )
    (bonusblock
      (type "retro")
      (z-pos 51)
      (x 15200)
      (y 736)
    )
    (brick
      (type "retro")
      (z-pos 51)
      (x 2496)
      (y 832)
      (breakable #f)
    )
    (brick
      (type "retro")
      (z-pos 51)
      (x 2528)
      (y 832)
      (breakable #t)
    )
    (brick
      (type "retro")
      (z-pos 51)
      (x 2464)
      (y 832)
      (breakable #t)
    )
    (brick
      (type "retro")
      (z-pos 51)
      (x 3552)
      (y 640)
      (breakable #t)
    )
    (brick
      (type "retro")
      (z-pos 51)
      (x 3456)
      (y 640)
      (breakable #t)
    )
    (brick
      (type "retro")
      (z-pos 51)
      (x 8064)
      (y 736)
      (breakable #f)
    )
    (brick
      (type "retro")
      (z-pos 51)
      (x 8352)
      (y 736)
      (breakable #t)
    )
    (brick
      (type "retro")
      (z-pos 51)
      (x 8768)
      (y 736)
      (breakable #t)
    )
    (brick
      (type "retro")
      (z-pos 51)
      (x 9056)
      (y 736)
      (breakable #t)
    )
    (brick
      (type "retro")
      (z-pos 51)
      (x 8896)
      (y 608)
      (breakable #t)
    )
    (brick
      (type "retro")
      (z-pos 51)
      (x 8928)
      (y 608)
      (breakable #f)
    )
    (brick
      (type "retro")
      (z-pos 51)
      (x 8192)
      (y 608)
      (breakable #t)
    )
    (brick
      (type "retro")
      (z-pos 51)
      (x 8224)
      (y 608)
      (breakable #t)
    )
    (camera
      (name "Camera")
      (mode "normal")
    )
    (coin
      (type "retro")
      (z-pos 49)
      (x 3264)
      (y 1088)
    )
    (coin
      (type "retro")
      (z-pos 49)
      (x 3296)
      (y 1088)
    )
    (coin
      (type "retro")
      (z-pos 49)
      (x 3328)
      (y 1088)
    )
    (coin
      (type "retro")
      (z-pos 49)
      (x 3328)
      (y 1120)
    )
    (coin
      (type "retro")
      (z-pos 49)
      (x 3296)
      (y 1120)
    )
    (coin
      (type "retro")
      (z-pos 49)
      (x 3264)
      (y 1120)
    )
    (coin
      (type "retro")
      (z-pos 49)
      (x 3264)
      (y 1152)
    )
    (coin
      (type "retro")
      (z-pos 49)
      (x 3296)
      (y 1152)
    )
    (coin
      (type "retro")
      (z-pos 49)
      (x 3328)
      (y 1152)
    )
    (coin
      (type "retro")
      (z-pos 49)
      (x 3328)
      (y 1184)
    )
    (coin
      (type "retro")
      (z-pos 49)
      (x 3296)
      (y 1184)
    )
    (coin
      (type "retro")
      (z-pos 49)
      (x 3264)
      (y 1184)
    )
    (coin
      (type "retro")
      (z-pos 49)
      (x 3296)
      (y 1216)
    )
    (coin
      (type "retro")
      (z-pos 49)
      (x 3264)
      (y 1216)
    )
    (coin
      (type "retro")
      (z-pos 49)
      (x 3328)
      (y 1216)
    )
    (coin
      (type "retro")
      (z-pos 49)
      (x 736)
      (y 992)
    )
    (coin
      (type "retro")
      (z-pos 49)
      (x 800)
      (y 992)
    )
    (coin
      (type "retro")
      (z-pos 49)
      (x 768)
      (y 992)
    )
    (coin
      (type "retro")
      (z-pos 49)
      (x 2240)
      (y 832)
    )
    (coin
      (type "retro")
      (z-pos 49)
      (x 2336)
      (y 832)
    )
    (coin
      (type "retro")
      (z-pos 49)
      (x 2304)
      (y 832)
    )
    (coin
      (type "retro")
      (z-pos 49)
      (x 2272)
      (y 832)
    )
    (coin
      (type "retro")
      (z-pos 49)
      (x 2208)
      (y 832)
    )
    (coin
      (type "retro")
      (z-pos 49)
      (x 7840)
      (y 736)
    )
    (coin
      (type "retro")
      (z-pos 49)
      (x 7936)
      (y 736)
    )
    (coin
      (type "retro")
      (z-pos 49)
      (x 7904)
      (y 736)
    )
    (coin
      (type "retro")
      (z-pos 49)
      (x 7872)
      (y 736)
    )
    (coin
      (type "retro")
      (z-pos 49)
      (x 8512)
      (y 512)
    )
    (coin
      (type "retro")
      (z-pos 49)
      (x 8608)
      (y 512)
    )
    (coin
      (type "retro")
      (z-pos 49)
      (x 8576)
      (y 480)
    )
    (coin
      (type "retro")
      (z-pos 49)
      (x 8544)
      (y 480)
    )
    (coin
      (type "retro")
      (z-pos 49)
      (x 9216)
      (y 512)
    )
    (coin
      (type "retro")
      (z-pos 49)
      (x 9280)
      (y 480)
    )
    (coin
      (type "retro")
      (z-pos 49)
      (x 9248)
      (y 480)
    )
    (coin
      (type "retro")
      (z-pos 49)
      (x 9312)
      (y 512)
    )
    (coin
      (type "retro")
      (z-pos 49)
      (x 11168)
      (y 832)
    )
    (coin
      (type "retro")
      (z-pos 49)
      (x 11200)
      (y 832)
    )
    (coin
      (type "retro")
      (z-pos 49)
      (x 11232)
      (y 832)
    )
    (coin
      (type "retro")
      (z-pos 49)
      (x 11264)
      (y 832)
    )
    (coin
      (type "retro")
      (z-pos 49)
      (x 11296)
      (y 832)
    )
    (coin
      (type "retro")
      (z-pos 49)
      (x 15296)
      (y 832)
    )
    (coin
      (type "retro")
      (z-pos 49)
      (x 15328)
      (y 800)
    )
    (coin
      (type "retro")
      (z-pos 49)
      (x 15360)
      (y 832)
    )
    (coin
      (type "retro")
      (z-pos 49)
      (x 15392)
      (y 800)
    )
    (coin
      (type "retro")
      (z-pos 49)
      (x 15424)
      (y 832)
    )
    (coin
      (type "retro")
      (z-pos 49)
      (x 15456)
      (y 800)
    )
    (decal
      (z-pos 50)
      (sprite "/images/decal/misc/flag.sprite")
      (x 15584)
      (y 768)
    )
    (gradient
      (top_color 0.5 0.7 1)
      (bottom_color 1 1 1)
      (z-pos -400)
    )
    (jumpy
      (type "bag")
      (z-pos 50)
      (x 10400)
      (y 864)
      (glinting #f)
    )
    (jumpy
      (type "bag")
      (z-pos 50)
      (x 12768)
      (y 672)
      (glinting #f)
    )
    (jumpy
      (type "bag")
      (z-pos 50)
      (x 12128)
      (y 672)
      (glinting #f)
    )
    (jumpy
      (type "bag")
      (z-pos 50)
      (x 13088)
      (y 960)
      (glinting #f)
    )
    (jumpy
      (type "bag")
      (z-pos 50)
      (x 12448)
      (y 960)
      (glinting #f)
    )
    (jumpy
      (type "bag")
      (z-pos 50)
      (x 13312)
      (y 512)
      (glinting #f)
    )
    (mriceblock
      (type "laptop")
      (z-pos 50)
      (x 5024)
      (y 992)
      (glinting #f)
    )
    (mriceblock
      (type "laptop")
      (z-pos 50)
      (x 4928)
      (y 992)
      (glinting #f)
    )
    (mriceblock
      (type "laptop")
      (z-pos 50)
      (x 6208)
      (y 832)
      (glinting #t)
    )
    (mriceblock
      (type "laptop")
      (z-pos 50)
      (x 5664)
      (y 1120)
      (glinting #f)
    )
    (mriceblock
      (type "laptop")
      (z-pos 50)
      (x 6752)
      (y 1120)
      (glinting #f)
    )
    (mriceblock
      (type "laptop")
      (z-pos 50)
      (x 6752)
      (y 800)
      (glinting #f)
    )
    (music
      (name "Music_Object")
      (file "/music/retro/ice_music.music")
    )
    (secretarea
      (width 104)
      (height 160)
      (x 3264)
      (y 1088)
    )
    (sequencetrigger
      (sequence "endsequence")
      (width 32)
      (height 128)
      (x 15616)
      (y 736)
    )
    (sequencetrigger
      (sequence "stoptux")
      (width 32)
      (height 32)
      (x 15968)
      (y 832)
    )
    (snowball
      (type "bsod")
      (z-pos 50)
      (x 1088)
      (y 1088)
      (glinting #f)
    )
    (snowball
      (type "bsod")
      (z-pos 50)
      (x 960)
      (y 1088)
      (glinting #f)
    )
    (snowball
      (type "bsod")
      (z-pos 50)
      (x 1888)
      (y 928)
      (glinting #f)
    )
    (snowball
      (type "bsod")
      (z-pos 50)
      (x 2752)
      (y 928)
      (glinting #f)
    )
    (snowball
      (type "bsod")
      (z-pos 50)
      (x 3648)
      (y 736)
      (glinting #f)
    )
    (snowball
      (type "bsod")
      (z-pos 50)
      (x 5120)
      (y 992)
      (glinting #f)
    )
    (snowball
      (type "bsod")
      (z-pos 50)
      (x 5664)
      (y 608)
      (glinting #f)
    )
    (snowball
      (type "bsod")
      (z-pos 50)
      (x 6208)
      (y 544)
      (glinting #f)
    )
    (snowball
      (type "bsod")
      (z-pos 50)
      (x 7328)
      (y 640)
      (glinting #f)
    )
    (snowball
      (type "bsod")
      (z-pos 50)
      (x 8128)
      (y 832)
      (glinting #f)
    )
    (snowball
      (type "bsod")
      (z-pos 50)
      (x 8064)
      (y 832)
      (glinting #f)
    )
    (snowball
      (type "bsod")
      (z-pos 50)
      (x 8480)
      (y 832)
      (glinting #f)
    )
    (snowball
      (type "bsod")
      (z-pos 50)
      (x 8832)
      (y 832)
      (glinting #t)
    )
    (snowball
      (type "bsod")
      (z-pos 50)
      (x 9184)
      (y 832)
      (glinting #f)
    )
    (spawnpoint
      (name "main")
      (x 64)
      (y 960)
    )
    (tilemap
      (solid #f)
      (z-pos -100)
      (name "MidGround_Tiles")
      (width 500)
      (height 40)
      (tiles -8413 0 93 94 95 96 -496 0 97 98 99 100 -253 0 93 94 95 96 -115 0 93 94 95 96 -377 0 97 98 99 100 -115 0 97 98 99 100 -135 0 93 94 95 96 -496 0 97 98 99 100 -1030 0 93 94 95 96 -29 0 4210 -3 4211 4212 -105 0 93 94 95 96 -353 0 97 98 99 100 -22 0 80 -6 0 4214 -3 4215 4216 -129 0 93 94 95 96 -74 0 93 94 95 96 -277 0 79 -6 0 4214 -3 4215 4216 -129 0 97 98 99 100 -74 0 97 98 99 100 -277 0 79 0 93 94 95 96 0 4214 -3 4215 4216 -247 0 93 94 95 96 -237 0 79 0 97 98 99 100 0 4214 -3 4215 4216 -357 0 93 94 95 96 -134 0 4218 -3 4219 4220 -54 0 93 94 95 96 -299 0 97 98 99 100 -193 0 97 98 99 100 -591 0 93 94 95 96 -496 0 97 98 99 100 -863 0 93 94 95 96 -496 0 97 98 99 100 -103 0 93 94 95 96 -61 0 93 94 95 96 -431 0 97 98 99 100 -61 0 97 98 99 100 -2308 0)
    )
    (tilemap
      (solid #f)
      (z-pos 100)
      (width 500)
      (height 40)
      (tiles -11997 0 38 -2 36 -497 0 38 -2 36 -497 0 38 -2 36 -497 0 5161 -2 36 -3101 0 -4 4000 4167 -495 0 -4 4000 4162 -495 0 -4 4000 4162 -495 0 -4 4000 4162 -495 0 -4 4000 4162 -495 0 -4 4000 4160 -495 0 -4 4000 4164 -394 0)
    )
    (tilemap
      (solid #t)
      (z-pos 0)
      (name "Main_Tiles")
      (width 500)
      (height 40)
      (tiles -76 0 4161 -41 4000 4078 -62 4000 4078 -45 4000 4078 4000 4162 -117 0 38 -152 36 -76 0 4161 -50 4000 4078 -24 4000 4078 -69 4000 4078 -5 4000 4078 4162 -117 0 38 -152 36 -76 0 4161 -152 4000 4162 -117 0 38 -152 36 -76 0 4161 -61 4000 4078 -77 4000 4078 -12 4000 4162 -117 0 38 -152 36 -76 0 4161 -91 4000 4078 -60 4000 4162 -117 0 38 -152 36 -76 0 4161 -124 4000 4078 -2 4000 4078 -24 4000 4162 -117 0 38 -152 36 -76 0 4161 -81 4000 4078 -19 4000 4078 -50 4000 4162 -117 0 38 -152 36 -76 0 4161 -107 4000 4167 -4 4079 4080 4079 4081 4080 -2 4079 4166 -33 4000 4162 -117 0 38 -152 36 -76 0 4161 4000 4078 -59 4000 4078 -35 4000 4167 -2 4079 -2 4080 -4 4079 4080 4165 -10 0 4103 -7 4079 4081 4080 -2 4079 4081 -3 4079 4166 -17 4000 4162 -117 0 38 -68 36 5176 -3 41 5175 -16 36 5176 -26 41 5175 -35 36 -76 0 4161 -90 4000 4167 -6 4079 4165 -36 0 4103 -4 4079 4166 -2 4000 4078 -9 4000 4162 -117 0 38 -65 36 5176 -2 41 42 -3 0 40 41 5175 -12 36 5176 41 42 -26 0 40 5175 -34 36 -76 0 4161 -40 4000 4078 -47 4000 4167 4079 4165 -48 0 4103 4080 4081 4166 -9 4000 4162 -117 0 38 -62 36 5176 -2 41 42 -8 0 40 -2 41 5175 -9 36 43 -29 0 40 5175 -33 36 -76 0 4161 -70 4000 4078 -15 4000 4167 4079 4165 -53 0 4103 4079 4080 4166 -6 4000 4162 -117 0 38 -34 36 5176 -4 41 5175 -20 36 5176 41 42 -14 0 40 41 5175 -5 36 5176 41 42 -30 0 40 41 5175 -31 36 -76 0 4161 -83 4000 4167 -2 4079 4165 -58 0 4103 -4 4079 4080 4079 4165 -117 0 38 -31 36 5176 -2 41 42 -4 0 40 -3 41 5175 -14 36 5176 41 42 -18 0 40 -2 41 5175 -2 36 43 -34 0 40 5175 -30 36 -76 0 4161 -80 4000 4167 4081 4079 4165 -186 0 38 -28 36 5176 -2 41 42 -11 0 40 -14 41 42 -23 0 40 -2 41 42 -35 0 40 5175 -29 36 -76 0 4161 -34 4000 4078 -3 4000 4167 -2 4080 -6 4079 4166 -10 4000 4167 4079 4080 4079 4080 -4 4079 4166 -11 4000 4167 4165 -189 0 38 -26 36 5176 41 42 -93 0 40 5175 -28 36 -76 0 4161 -27 4000 4167 -9 4079 4081 4165 -8 0 4103 4080 -2 4079 4080 -2 4079 4080 4079 4080 4079 4165 -8 0 4103 4081 -2 4079 4081 4079 4080 -5 4079 4165 -44 0 4100 -10 4102 4101 -134 0 38 -23 36 5176 -2 41 42 -96 0 40 5175 -27 36 -76 0 4161 -20 4000 4078 -4 4000 4167 4080 4165 -96 0 4157 -2 4001 4002 -2 4003 -5 4002 4158 -134 0 38 -20 36 5176 -2 41 42 -100 0 40 5175 -26 36 -76 0 4161 -22 4000 4167 -2 4079 4165 -81 0 4100 -10 4102 4101 -5 0 4161 -10 4000 4162 -134 0 38 -17 36 5176 -2 41 42 -43 0 33 -7 32 34 -52 0 38 -26 36 -76 0 4161 -18 4000 4167 4080 4079 4081 4165 -84 0 4157 -2 4001 -2 4003 4001 4002 4001 -2 4003 4001 4158 -5 0 4103 4081 -2 4079 4080 4079 4080 4079 4080 4079 4080 4165 -134 0 40 -8 41 5175 -5 36 5176 -2 41 42 -46 0 119 -7 121 120 -4 0 1741 -47 0 40 -2 41 5175 -23 36 -76 0 4161 -13 4000 4167 -4 4079 4165 -71 0 4100 -10 4102 4101 -5 0 4161 -10 4000 4162 -68 0 4100 -6 4102 4101 -14 0 4100 -6 4102 4101 -62 0 38 -3 36 5176 41 42 -62 0 1740 -50 0 40 41 5175 -21 36 -76 0 4161 -9 4000 4167 4081 4079 4081 4165 -76 0 4157 4003 -3 4001 4003 -5 4001 4158 -5 0 4103 4080 4079 4080 4079 4081 -5 4079 4165 -22 0 4100 -10 4102 4101 -34 0 4181 4170 4171 5112 5108 4172 4170 4182 -14 0 4181 -2 4170 5112 5108 -2 4170 4182 -62 0 40 -3 41 42 -64 0 5190 -7 32 34 -5 0 33 -6 32 34 -5 0 33 -6 32 34 -18 0 40 -2 41 5175 -18 36 -76 0 4103 -2 4079 4080 4079 -2 4081 4079 4080 4079 4165 -66 0 4100 -4 4102 4101 -8 0 4161 -10 4000 4162 -39 0 4157 4002 -3 4001 4003 4001 -2 4002 -2 4001 4158 -37 0 4161 4162 -20 0 4161 4162 -96 0 33 -3 32 34 -15 0 33 -3 32 34 -13 0 5188 -7 37 39 -5 0 35 -6 37 39 -5 0 35 -6 37 39 -21 0 40 -2 41 5175 -15 36 -141 0 4100 -4 4102 4101 -3 0 4100 -2 4102 4168 4001 4003 -2 4001 4169 -2 4102 4101 -5 0 4103 -2 4080 4081 4079 4080 -3 4079 4081 4079 4165 -39 0 4161 -4 4000 4078 -5 4000 4160 -5 4102 4101 -17 0 4100 -6 4102 4101 -6 0 4161 4162 -6 0 4100 -6 4102 4101 -6 0 4161 4162 -86 0 33 -3 32 34 -5 0 35 -3 37 39 -5 0 33 -3 32 34 -5 0 35 -3 37 39 -13 0 38 -7 36 43 -5 0 38 -6 36 43 -5 0 38 -6 36 43 -24 0 40 -12 41 5175 -2 36 -104 0 4100 -10 4102 4101 -22 0 4100 -2 4102 4168 -2 4003 4001 4002 4169 -3 4102 4168 4002 4001 4163 -4 4000 4164 4001 4002 4158 -56 0 4161 -10 4000 4164 4001 4003 4001 4002 4001 4158 -17 0 4181 4171 4172 5112 5108 -2 4171 4182 -6 0 4161 4162 -6 0 4181 4171 4172 5112 5108 -2 4171 4182 -6 0 4161 4162 -76 0 33 -3 32 34 -5 0 35 -3 37 39 -5 0 40 -3 41 42 -5 0 35 -3 37 39 -5 0 40 -3 41 42 -13 0 38 -7 36 43 -5 0 38 -6 36 43 -5 0 38 -6 36 5162 -7 32 34 -27 0 27 29 -103 0 4100 -3 4102 4168 -7 4001 4002 -2 4003 4158 -22 0 4157 -2 4001 4163 -4 4000 4164 -3 4001 4163 -5 4000 4078 -4 4000 4162 -56 0 4161 -16 4000 4160 -5 4102 4101 -14 0 4161 4162 -9 0 4161 4162 -9 0 4161 4162 -9 0 4161 4162 -76 0 35 -3 37 39 -5 0 40 -3 41 42 -15 0 40 -3 41 42 -11 0 33 34 -10 0 38 -7 36 43 -5 0 38 -6 36 43 -5 0 38 -6 36 5169 -7 37 39 -129 0 4100 -2 4102 4168 4001 -2 4002 4163 -10 4000 4162 -5 0 4100 -10 4102 4101 -5 0 4161 -3 4000 4167 4079 4080 4166 -8 4000 4167 4079 4080 4166 -3 4000 4162 -39 0 4100 -10 4102 4101 -5 0 4161 -16 4000 4164 4002 -4 4001 4158 -14 0 4161 4162 -9 0 4161 4162 -9 0 4161 4162 -9 0 4161 4162 -76 0 40 -3 41 42 -41 0 119 120 -10 0 38 -7 36 43 -5 0 38 -6 36 43 -5 0 38 -14 36 43 -127 0 4100 4102 4168 -2 4001 4163 -14 4000 4162 -5 0 4157 -7 4001 -2 4002 4003 4158 -5 0 4103 -3 4079 4165 -2 0 4103 4079 -2 4080 4079 -3 4080 4079 4165 -2 0 4103 -2 4079 4080 4165 -22 0 4100 -10 4102 4101 -5 0 4157 -2 4001 4002 -3 4001 -2 4002 4001 4002 4158 -5 0 4161 -22 4000 4160 -14 4102 4159 4160 -9 4102 4159 4160 -9 4102 4159 4160 -9 4102 4159 4160 -2 4102 4101 -53 0 33 -7 32 34 -69 0 38 -7 36 43 -5 0 38 -6 36 43 -5 0 38 -14 36 5162 -29 32 -95 0 4100 -2 4102 4168 4001 4163 -17 4000 4162 -5 0 4161 -10 4000 4162 -2 0 4185 -31 0 4100 -10 4102 4101 -5 0 4157 4003 4001 4002 -3 4001 4003 -3 4001 4158 -5 0 4161 4078 -9 4000 4162 -3 0 4185 0 4161 -22 4000 4164 -2 4001 4002 -2 4001 4002 -2 4001 4003 -5 4001 4163 4164 4002 4001 4002 -3 4001 4002 4001 4003 4163 4164 4002 4001 4002 -2 4001 4002 4003 4002 4001 4163 4164 4002 4001 4003 -2 4001 4002 -2 4001 4002 4163 4164 4001 4002 4169 -2 4102 4101 -35 0 4100 -3 4102 4101 -10 0 35 -7 37 39 -60 0 33 -3 32 34 -4 0 38 -7 36 43 -5 0 38 -6 36 43 -5 0 38 -14 36 5169 -29 37 5168 -2 36 -88 0 4100 -3 4102 4168 4001 4003 4163 -19 4000 4162 -5 0 4161 -4 4000 4078 -5 4000 4162 -2 0 4189 -31 0 4157 -2 4001 4003 -4 4001 4002 4001 4002 4158 -5 0 4161 -10 4000 4162 -5 0 4103 4079 4081 -2 4079 4080 4079 4080 4079 4081 4080 4165 -3 0 4189 0 4161 -20 4000 4078 -40 4000 4078 -12 4000 4164 4003 4001 4169 -2 4102 4101 -23 0 4100 -3 4102 4101 -4 0 4181 4170 5104 4170 4182 -10 0 38 -7 36 5162 -5 32 34 -54 0 35 -3 37 39 -4 0 38 -7 36 43 -5 0 38 -6 36 43 -5 0 38 -47 36 -48 0 4100 -11 4102 4101 -5 0 4100 -21 4102 4168 -3 4001 4163 -22 4000 4162 -5 0 4103 4080 -3 4079 -3 4080 4079 -2 4080 4165 -34 0 4161 -10 4000 4162 -5 0 4103 -2 4079 4081 -7 4079 4165 -22 0 4161 -3 4000 4078 -73 4000 4164 4003 4001 4169 -2 4102 4101 -11 0 4100 -3 4102 4101 -4 0 4181 4170 5104 4172 4182 -6 0 4187 -12 0 38 -7 36 5169 -5 37 39 -5 0 33 -3 32 34 -44 0 40 -3 41 42 -4 0 38 -7 36 43 -5 0 38 -6 36 43 -5 0 38 -47 36 -45 0 4100 -2 4102 4168 4002 4001 4003 -2 4001 4003 -2 4001 4003 -2 4001 4158 -5 0 4157 -2 4002 -3 4001 -2 4002 -2 4001 4003 -3 4001 4003 -4 4001 4002 -2 4001 4163 -7 4000 4078 -18 4000 4162 -51 0 4103 -2 4079 4081 -3 4079 4080 -2 4079 4081 4165 -39 0 4161 -80 4000 4164 4001 4002 4169 -6 4102 4101 -4 0 4181 4170 5104 4170 4182 -6 0 4187 -8 0 4187 -8 0 33 -3 32 5161 -13 36 43 -5 0 35 -3 37 39 -5 0 33 -3 32 34 -15 0 33 -3 32 34 -23 0 38 -7 36 43 -5 0 38 -6 36 43 -5 0 38 -47 36 -6 4102 4101 -35 0 4100 -2 4102 4168 -2 4001 4163 -11 4000 4162 -5 0 4161 4000 4078 -25 4000 4078 -20 4000 4162 -22 0 4100 -22 4102 4101 -52 0 4185 -3 0 4161 -83 4000 4164 4002 4003 -4 4001 4158 -6 0 4187 -8 0 4187 -8 0 4187 -8 0 35 -3 37 5168 -13 36 43 -5 0 38 -3 36 43 -5 0 35 -3 37 39 -5 0 33 -3 32 34 -5 0 35 -3 37 39 -5 0 33 -3 32 34 -13 0 38 -7 36 43 -5 0 38 -6 36 43 -5 0 38 -47 36 4003 4001 4002 4003 -2 4001 4169 -2 4102 4101 -29 0 4100 -2 4102 4168 -2 4001 4163 -14 4000 4162 -5 0 4161 -48 4000 4162 -22 0 4157 4001 4002 -3 4001 4002 4001 4003 4001 -2 4002 -6 4001 4002 4001 4003 4001 4002 4158 -52 0 4189 -3 0 4161 -60 4000 4078 -22 4000 4078 -6 4000 4162 -6 0 4187 -8 0 4187 -8 0 4187 -8 0 38 -17 36 43 -5 0 38 -3 36 43 -5 0 38 -3 36 43 -5 0 35 -3 37 39 -5 0 38 -3 36 43 -5 0 35 -3 37 39 -13 0 38 -7 36 43 -5 0 38 -6 36 43 -5 0 38 -47 36 -6 4000 4164 -2 4001 4169 -2 4102 4101 -23 0 4100 -2 4102 4168 -2 4001 4163 -17 4000 4162 -5 0 4161 -35 4000 4079 4080 -7 4079 4080 -2 4079 4081 4165 -22 0 4161 -22 4000 4162 -56 0 4161 -68 4000 4078 -21 4000 4162 -6 0 4187 -8 0 4187 -8 0 4187 -8 0 38 -17 36 43 -5 0 38 -3 36 43 -5 0 38 -3 36 43 -5 0 38 -3 36 43 -5 0 38 -3 36 43 -5 0 38 -3 36 43 -13 0 38 -7 36 43 -5 0 38 -6 36 43 -5 0 38 -47 36 -9 4000 4164 -2 4001 4169 -23 4102 4168 4002 4003 4163 -17 4000 4078 4000 4167 4165 -5 0 4103 4166 -9 4000 4078 -24 4000 -36 0 4161 -22 4000 4162 -56 0 4161 -7 4000 4078 -16 4000 4078 -41 4000 4078 -23 4000 4162 -6 0 4187 -8 0 4187 -8 0 4187 -8 0 38 -17 36 43 -5 0 38 -3 36 43 -5 0 38 -3 36 43 -5 0 38 -3 36 43 -5 0 38 -3 36 43 -5 0 38 -3 36 43 -13 0 38 -7 36 43 -5 0 38 -6 36 43 -5 0 38 -47 36 -12 4000 4164 4001 -2 4002 -4 4001 -2 4002 -5 4001 -3 4002 -2 4001 4002 -3 4001 4163 -14 4000 4078 -7 4000 4162 -7 0 4161 -34 4000 -19 0 4100 -10 4102 4101 -5 0 4161 -22 4000 4162 -5 0 4100 -10 4102 4101 -5 0 4100 -10 4102 4101 -5 0 4100 -10 4102 4101 -5 0 4161 -90 4000 4162 -6 0 4187 -8 0 4187 -8 0 4187 -8 0 38 -17 36 43 -5 0 38 -3 36 43 -5 0 38 -3 36 43 -5 0 38 -3 36 43 -5 0 38 -3 36 43 -5 0 38 -3 36 43 -13 0 38 -7 36 43 -5 0 38 -6 36 43 -5 0 38 -47 36 -59 4000 4162 -7 0 4161 -31 4000 4078 -2 4000 -19 0 4157 4001 -2 4003 -3 4001 4003 -3 4001 4158 -5 0 4161 -22 4000 4162 -5 0 4157 4001 4002 4001 4002 4001 4003 -4 4001 4158 -5 0 4157 -5 4001 4002 -3 4001 4003 4158 -5 0 4157 -5 4001 4003 4001 4003 4002 4001 4158 -5 0 4161 -73 4000 4078 -16 4000 4162 -6 0 4187 -8 0 4187 -8 0 4187 -8 0 38 -17 36 43 -5 0 38 -3 36 43 -5 0 38 -3 36 43 -5 0 38 -3 36 43 -5 0 38 -3 36 43 -5 0 38 -3 36 43 -13 0 38 -7 36 43 -5 0 38 -6 36 43 -5 0 38 -47 36 -14 4000 4078 -44 4000 4162 -7 0 4161 -5 4000 4078 -28 4000 -19 0 4161 -10 4000 4162 -5 0 4161 -22 4000 4162 -5 0 4161 -10 4000 4162 -5 0 4161 -10 4000 4162 -5 0 4161 -10 4000 4162 -5 0 4161 -90 4000 4162 -6 0 4187 -8 0 4187 -8 0 4187 -8 0 38 -17 36 43 -5 0 38 -3 36 43 -5 0 38 -3 36 43 -5 0 38 -3 36 43 -5 0 38 -3 36 43 -5 0 38 -3 36 43 -13 0 38 -7 36 43 -5 0 38 -6 36 43 -5 0 38 -47 36 -58 4000 4167 4165 -7 0 4103 4166 -33 4000 -13 4102 4101 -5 0 4161 -10 4000 4162 -5 0 4161 4078 -21 4000 4162 -5 0 4161 -9 4000 4078 4162 -5 0 4161 -4 4000 4078 -5 4000 4162 -5 0 4161 -10 4000 4162 -5 0 4161 -53 4000 4078 -4 4000 4078 -6 4000 4078 -24 4000 4162 -6 0 4187 -8 0 4187 -8 0 4187 -8 0 38 -17 36 43 -5 0 38 -3 36 43 -5 0 38 -3 36 43 -5 0 38 -3 36 43 -5 0 38 -3 36 43 -5 0 38 -3 36 43 -13 0 38 -7 36 43 -5 0 38 -6 36 43 -5 0 38 -47 36 -22 4000 4078 -35 4000 4162 -9 0 4161 -33 4000 4003 -12 4001 4158 -5 0 4161 -10 4000 4162 -5 0 4161 -22 4000 4162 -5 0 4161 -10 4000 4162 -5 0 4161 -9 4000 4078 4162 -5 0 4161 -10 4000 4162 -5 0 4161 -90 4000 4162 -6 0 4187 -8 0 4187 -8 0 4187 -8 0 38 -17 36 43 -5 0 38 -3 36 43 -5 0 38 -3 36 43 -5 0 38 -3 36 43 -5 0 38 -3 36 43 -5 0 38 -3 36 43 -13 0 38 -7 36 43 -5 0 38 -6 36 43 -5 0 38 -47 36)
    )
    (tilemap
      (solid #f)
      (tint 0.5 0.5 1)
      (z-pos -99)
      (width 500)
      (height 40)
      (tiles -15558 0 2141 2142 2019 2140 2141 2142 2019 2140 2141 2142 2019 -489 0 -11 2020 -489 0 -11 2020 -240 0 2140 2141 2142 2019 2140 2141 2142 2019 2140 2141 2142 2019 2140 2141 2142 2019 2140 2141 2142 2019 2140 2141 2142 2019 2140 2141 2142 2019 2140 2141 2142 2019 2140 2141 2142 2019 2140 2141 2142 2019 2140 -208 0 -11 2020 -240 0 -41 2020 -208 0 -11 2020 -240 0 -41 2020 -208 0 -11 2020 -240 0 -41 2020 -208 0 -11 2020 -92 0 2140 2141 2142 2019 2140 2141 2142 2019 2140 2141 2142 2019 2140 2141 2142 2019 2140 2141 2142 2019 2140 2141 2142 2019 2140 2141 2142 2019 2140 2141 2142 2019 2140 2141 2142 2019 2140 2141 2142 2019 2140 2141 2142 2019 2140 2141 2142 2019 2140 2141 2142 2019 2140 2141 2142 2019 2140 2141 -90 0 -41 2020 -208 0 -11 2020 -63 0 2019 2140 2141 2142 2019 2140 2141 2142 2019 2140 2141 2142 2019 2140 2141 -14 0 -58 2020 -90 0 -41 2020 -208 0 -11 2020 -46 0 2142 2019 2140 2141 2142 2019 2140 2141 2142 2019 2140 2141 2142 2019 2140 2141 2142 -15 2020 2142 2019 2140 2141 2142 2019 2140 2141 2142 2019 2140 2141 2142 2019 -58 2020 -90 0 -41 2020 -150 0)
    )
  )
)
